9,9,9,9,9,9,9,9,9,9,9,9,9,9,9,9
0,4,4,4,4,6,4,4,4,4,4,0,0,0,0,0
0,4,4,4,5,5,4,4,5,4,4,0,4,6,4,4
0,6,4,4,5,5,4,4,5,4,4,0,4,4,4,4
0,4,4,4,5,5,4,4,5,4,4,0,4,5,5,5
0,4,4,4,5,5,6,4,5,6,4,0,4,5,5,5
0,0,4,4,5,5,4,4,5,4,4,0,4,5,5,5
4,0,4,4,4,4,4,6,4,6,4,0,4,4,4,4
4,0,0,0,0,4,4,4,4,4,4,0,4,4,4,4
5,4,4,4,0,4,4,4,4,4,4,0,4,4,4,5
5,5,4,4,0,0,0,0,0,0,0,0,4,4,5,5
4,4,4,4,4,4,4,4,4,4,4,4,4,4,4,4
4,4,4,4,4,4,4,4,4,4,4,4,4,4,4,4
4,4,4,4,4,4,4,4,4,4,4,4,4,4,4,4
4,4,4,4,4,4,4,4,4,4,4,4,4,4,4,4
4,4,4,4,4,4,4,4,4,4,4,4,4,4,4,4
4,4,4,4,4,4,4,4,4,4,4,4,4,4,4,4

